-================================================================-
-=-----------------------------------------==-------------------=-
-=-----------------------------------------==----*#+----=**=----=-
-=-----------------------------------------==----#%%=---*@@=----=-
-=-----------------------------------------==----####--=%+@=----=-
-==+*--------------------------------------==----##+@+-%*=@=----=-
-==#@--------------------------------------==----##-*%*%==@=----=-
-==#@--------------------------------------==----##--%@=-=@=----=-
-==#@--------------------------------------==-------------------=-
-==#@--------------------------------------======================-
-==#@%%%%#=--------------------------------==-------------------=-
-=-----------------------------------------==----===-----==-----=-
-=-----------------------------------------==----#@%=---+@@=----=-
-=-----------------------------------------==----##@+--=%+@=----=-
-=-----------------------------------------==----##+@=-*#=@=----=-
-============================================----##-%#=@==@=----=-
-=---------------------=-------------------==----##-=@@*-=@=----=-
-=---------------------=-------------------==----++--=+--=+=----=-
-=-----*@@=---=@@+-----=----=@@*---=#@#=---==-------------------=-
-=-----*@##--=##@+-----=----=@*@=--=%##=---======*#+=====##======-
-=-----*@=@+-=%-@+-----=----=@+##-=%+##=---==----#%%=---*@@=----=-
-=-----*@-*@=@*-@+-----=----=@+=@+##=##=---==----###*--=%+@=----=-
-=-----*@--%@%--@+-----=----=@+-*@%=-##=---==----##+@=-#*=@=----=-
-=-----=+--=+=--+=-----=----=+=-=+=--===---==----##-*%*%==@=----=-
-=---------------------=-------------------==----##--%@=-=@=----=-
------------------------------------------------------------------
